000000000000000000000000000000000000000
0W00000000000000000000000000000000000W0
000000000000000000000000000001000000000
00000000HHHHHHHH000000R00000000000T0T00
00000000V40000CV0000000000000000000T000
00000000VT00U00V000000T0000000000000000
00000000KHHHH80V000000TT000000000000000
00000000V0000V0000000000000000000000000
00000000KHHHHVC000000T00000000000000V00
0000000T0000B000000HHHHHHHHHHHH00000V00
00000000TT000000000V20000000000V0000V00
000000T00T000000000V00000E0T000V0000000
0000000T0000B000000V00000000000V0000V00
00000000TT000Y00000V00000000000V0000V00
000000T00T000000000V00000000000V0000000
0000000T0000B000000KHHHHH90HHHHV0000V00
00000000TT00000000000000000000000000V00
000000T00T000000000000000P0000000000000
0000000T0000B000T0000000000000000000V00
0W00000000000000000000000000000000000W0
000000000000000000000000000000000000000