0000000000000000000000000000000000000000000000000000000000000000000000000000000000000000000000000000
0W000000000000000000000000000000000000000000000000000000000000000000000000000000000000000000000000W0
0000000000000000000000000000000000000000000000000000000000000000000000000000000000000000000000000000
00000000HHHHHHHC000000000000000000T0T00000000000000000000000000HHHHHHHHB0000000000000T00000000000000
00000000V00000C00000000000000000000T0000000000000000000TT00000000000000000000000000000T0000000000000
00000000V0000000000000T000000000000000000000000000000000T0000000V0000V0000000000T0000TTT000000000000
00000000V0KHH000000000TT0000000000000HHH000000000000000000000000KHHHHV000000000000000000000000000000
00000000V00O0V00000000000000000000000000V000000000000000000000000CC00000000000000000000T00T000000000
00000000KHHHHVC000000T00000000000000V000V00000TT0000000000000000000000000000TT0000000000000000000000
0000000T0000B00000000000000000000000V000V0000000T0000000000000000000000000000000000T0000000000000000
00000000TT00000000000000000000000000V00000000000000T000000000000000000000000000000000000000000000000
000000T00T000000000000000000000000000000000000000000T00000000000000TTT000000000000000000000000000000
000000000000000000000000000TT00000000T00000000000000000000000000000000000000000000000000000000000000
000000000000000000000000000T000000000000000000000000000000000000000000000000000000000000000000000000
0000000000TT000000000000000000000000000000000000000000000T00000000000000000000T0000000000T0000000000
0000000000000000000000TTTT000000000000BBHHH000000000000000000T00000000000000000000000000000000000000
000000000000000000000000TT000000000O00B000V00V00000000000000000000000000000000T000000000000000000000
0000000000000000000000000000000000000000P00C0V000000000000000000TTT0000000000000000T0000000000000000
000000TT000000000000000000T0000000000CC000000V000000000000000000000000000000000000000000000000000000
000000000BV000000000000T0000000000000C0000000000000000000TT000000000000000000000CC0B0000000000000000
0000000000V000000000000000000TT00000000000000000000000000000000000000000000000000CB00000000000000000
0000000000V00000000000000000000000T000000T0000000000000000000000000000000TT0000000C00000000000000000
0000000000KHHH00000000000000000000000000000000000000000000000000000000000000000HHHHH0000000000000000
00000000000000T000000000000000000000T0000000000000HH00000000000000000000000V000V00000000000000000000
000000000000000T0000000000000000000000000000000000V000000000T00000000000000V000V00000000000000000000
00000000000000000000000000000000000000000000000000V0HHHC000000000000000000CV000000000000000000000000
000000000000000000000000000000000TTT00000000000000V000BC0000000000000000000V000000000000000000000000
0000000000000000000000000000000000000000000000000000000000000000000000000000000TTT000000000000000000
0000000000000000000000000000000000000000000TTT0000000000000000000000000TT000000000000000000000000000
000000000000000TTT0000000000000000000000000T00000000000000000000T0HHHHH00000000000000000000000000000
00000000HHHHHHHH0000000000000000000000000TT0000000000000000T000T00V000CV0000000000000000000000000000
00000000V0000000KHH000000000000000000V0000000000000000000000000000V00T0V0000000000T00T00000000000000
00000000V000V00000000V000000000000000V0HH0000000000000000000000000G0000V000000000TT00000000000000000
00000000VO00V0000000CV000000T00000000V000000TT00000000C00000000T00V0000V000000000T000000000000000000
00000000V000V0000000CV0000000T0000000KH000000000000000BB00000000T0V00O0V0000000000000000000000000000
00000000KHHHHHHHHHHHHV00000000000000000000000000000000000000000000KHHHHV0000000000000000000000000000
0000000000000000000000000000000000000000000000000000000000000000000000000000000000000000000000000000
0000000000000000000000000000000000000000000000000000000000000000000000000000000000000000000000000000
0W000000000000000000000000000000000000000000000000000000000000000000000000000000000000000000000000W0
0000000000000000000000000000000000000000000000000000000000000000000000000000000000000000000000000000