0000000000000000000000000000000000000000000000000000000000000000000000000000000000000000000000000000
0W000000000000000000000000000000000000000000000000000000000000000000000000000000000000000000000000W0
0000000000000000000000000000000000000000000000000000000000000000000000000000000000000000000000000000
0000000000000000000000000000000000000000000000000000000000000000000000000000000000000000000000000000
00000000HHHHHHHHHHH9HHHHHH00000000T0T000000000000000000HHHHHHHHB0000000000000T0000000000000000000000
00000000V00000C00000000000V00000000T0000000000000000000TT00000000000000000000000000000T0000000000000
00000000V0000000000000T000V00000000000000000000000000000T0000000V0000V0000000000T0000TTT000000000000
00000000V0KHH000000000TT00V0000000000HHH000000000000000000000000KHHHHV000000000000000000000000000000
00000000V00O0V000000000000V0000000000000V000000000000000000000000CC00000000000000000000T00T000000000
00000000V000000000000T0000V000000000V000V00000TT0000000000000000000000000000TT0000000000000000000000
0000000TV000B0000000000000V000000000V000V0000000T0000000000000000000000000000000000T0000000000000000
00000000VT0000000000000000V000000000V00000000000000T000000000000000000000000000000000000000000000000
000000T0VT0000000000000000V0000000000000000000000000T00000000000000TTT000000000000000000000000000000
00000000V00000000000000000VTT00000000T00000000000000000000000000000000000000000000000000000000000000
00000000V00000000000000000VT0000000000000000000M0000000000000000000000000000000000000000000000000000
00000000V0TT00000000000000V000000000000000000000000000000T00000000000000000000T0000000000T0000000000
00000000V0000000000000TTTTV00000000000BBHHH000000000000000000T00000000000000000000000000000000000000
00000000V000000000000000TTV00000000O00B000V00V00000000000000000000000000000000T000000000000000000000
00000000V00000000000000000V0000000000100P00C0V000000000000000000TTT0000000000000000T0000000000000000
000000TTT00000000000000000V00000000000CC000000V00000000000000000000000000000000000000000000000000000
00000000VBV000000000000T00V0000000000C0000000000000000000TT000000000000000000000CC0B0000000000000000
00000000V0V000000000000000V00TT00000000000000000000000000000000000000000000000000CB00000000000000000
00000000V0V000000000000000V0000000T000000T0000000000000000000000000000000TT0000000C00000000000000000
00000000VHHHHHHHTTT8HHHHHHV0000000000000000000000000000000000000000000000000000HHHHH0000000000000000
00000000V00000T00000000000V000000000T0000000000000HH00000000000000000000000V000V00000000000000000000
00000000V000000T0000000000V00000000000000000000000V000000000T00000000000000V000V00000000000000000000
00000000V00000000000000000V00000000000000000000000V0HHHC000000000000000000CV000000000000000000000000
00000000V00000000000000000V000000TTT0000000TTT0000V000BC0000000000000000000V000000000000000000000000
00000000V00000000000000000V000000000000000000T000000000000000000000000000000000TTT000000000000000000
00000000V00000000000000000V0000000000000000T0T0000000000000000000000000TT000000000000000000000000000
000000000000000000000000000HHHHHHHHHHHHHHHHT90HHHHHHHHHHHHHHHHHHHHHHHHTHHHHHHHHHHH000000000000000000
00000000V00000000000000000V000000TT0000000000000000T000T00V000CV000000000000000000V00000000000000000
00000000V0200000KHHHHV0000V0000000000V0000000000000000000000000000V00T0V0000000000V00T00000000000000
00000000V000V00000000V0000T0000000000V0HH0000000000000000000000000G0000V000000000TV00000000000000000
00000000VO00V0000000CV0000V0T00000000V000000TT00000000C00000000T00V0000V000000000TV00000000000000000
00000000V000V0000000CV0000V00T0000000KH000000000000000BB00000000T0V00O0V0000000000V00000000000000000
00000000KHHHHHHHHHHHHHHHHHVHHHHHHHHHHHHHHHHHHHHHHHHHHHHHHHHHHHHHHHHHHHHHHHHHHHHHHHV00000000000000000
0000000000000000000000000000000000000000000000000000000000000000000000000000000000000000000000000000
0000000000000000000000000000000000000000000000000000000000000000000000000000000000000000000000000000
0W000000000000000000000000000000000000000000000000000000000000000000000000000000000000000000000000W0
0000000000000000000000000000000000000000000000000000000000000000000000000000000000000000000000000000