0000000000000000000000000000000000000000000000000000000000000000000000000000000000000000000000000000
0W00000000000000000000000000000000000000000000000000000B000000000000000000000000000000000000000000W0
0000000000000000000000000000000000000000000000000000000000000000000000000000000000000000000000000000
0000T00P0000000000000000000000000000000000000000000000000000000000000000000000000000000000000T0T0000
0000T0000000000000000000000000000000000000000000000000000000000000000000T00000000000000000000BT00000
0000T00000000000000000000000000000000000000000000000000000000000000000000000000B0BB0000000000CT00000
00000000000000000000000000000000BT00000000BB000000000000000000000000000000T0CC00000000T0000000000000
000000000000000000000000000000000000000T00CCC0000000000000000000000000000T000B0000000T00000000000000
000000000000000000000000000000000000000T0000000000000000000000000000000000000T0000000000000000000000
0000000000000000000000000000000000000000000T0000000000000000000000000000TB0000000000T000000000000000
0000000000000000000000000000000BB0000000000000T00000000000000000000000000000000000000000000TT0000000
00000000000000000000000000T000000C0000T0000000000000000000000000000000000000000000000000000000000000
0000000000000000000000000000000000000000000000T00000000000300000000000000000000000000000000000000000
0000000000000000000000000B0000000T0000000T0000000000000000000000000000000000000000000000000000000000
0000000000000000000000000BC0TT0000000000000000000000000000000000000000000000000000000000000000000000
00000000000000000000000000000000000000CC000000000000000000000000000000000000000000000000000000000000
0000000000000000000000000000000000000000000000000000000000000000000000000000000000000000000000000000
0000000000000000001000000T000TCC0000000BBT0000000000000000000000000000000000000000000000000000000000
0000000000000000000000000000T000000T0000C00000T00000000000000000000000000000000000000000000000000000
0000000000000000000000000000000000TT00000TT00000000000000000000000000000T000000000000000000000000000
000000000000000000000000000TT00000000000T000000000000000000000000000000T0000000000000000000000000000
00000000000000000000000000T000000TT000T000000B000000000000000000000000000000000000000000000000000000
0000000000000000000000000000000000T000000000TT00000000000000000000000000T000000000000400000000000000
0000000000000000000000000000000000000T0000000000000000000T000000000000000000000000000000000000000000
0000000000000000000000000000000000000000T000000000000000000000T0000000000000000000000000000000000000
0000000000000000000000000000000000000000000000000000000000000000000000000000000000000000000000000000
000000000000000000B000000000000000000000000000000000000000000000000000000000000000000000000000000000
000000000000000CC00T00000000000000000000000000000000000000000000T00000000000000000000000000000000000
00000T0000T0000000000T000000000000000000000000000000000000000000000000000000000000000000000000000000
0000000T000000000000000000000000000000000000000000000000000000TT00C000T00000000000000000000000000000
0000BB0000000000000T0000000000000000000000000000000000000T00000BBBC000TT0000000000000000000000000000
000000C00000T0000000000TT000000000000000000000000000000000T00C00C0000T000T00000000000000000000000000
000000000000TT000000000000000000000000000000000000000000000000000000T00T0000000000000000000000000000
00000000T000000000T000000000000000000000000000000000000000000B000000000T000000000BB00000000000000000
00000000000000000T0000000000000000000000000000000000000000000000000B0000000000TT00000000000000000000
00000000000000000000T000000000000000000000000000000000000000000000000B00000T000000TTT000000000000000
000000T0000000T000000000000000000000000000020000000000000000000B000000T000T000000CC00000000000000000
00000000000TT00000000000T0000000000000000000000000000000000000TT00T000000000B0B0000TT000000000000000
0000000CB00000000000000T0000000000000000000000000000000000000T0000000TT00T00000000000000000000000000
00000000000000000TTT000000000000000000000000000000000000000000000000T00T0000000C000000T0000000000000
000000000000000000000000000000000000000000000000000000000000000000000000TT0000BB00000000000000000000
0000T0TT0000000000T00000T00000000000000000000000000000000000000000000000T0000CCC000T0000000000000000
0000T0T0BB000000000000000000000000000000000000000BBBBTBC00CC00T000TTT0000T000000T0000000000000000000
0000000T000C000000000000000T00000000T000000000000CC000000CCCT0000000000000T000000TT00T00000000000000
000000T000000000T0T0000T000000000T00000TT000T0000BBCCTBCC000000000000000T00000TT000000TT000000000000
000000000000000000000T000000000T0000T0000000000T00TB000000T00TT0TTT00000000T00000TTT0000000000000000
0000000000000000000000000000000000000000000000000000000CC00CT000000T00000000000000000000000000000000
0000000000000000000000000000000000000000000000000000000000000000000000000000000000000000000000000000
0W000000000000000000000000000000000000000000000000000000000000000000000000000000000000000000000000W0
0000000000000000000000000000000000000000000000000000000000000000000000000000000000000000000000000000