TTTTTTTTTTTTTT000000T0TTTT0000T0TTTTTTTTTTTTTT000000T0TTTT0000T0TTTTTTTTTTTTTT000000T0TTTT0000T00000
T00T00000TTTTT000000T0TTTT0000T0TTTTTTTTTTTTTT000000T0TTTT0000T0TTTTTTTTTTTTTT000000T0TTTT0000T00000
T0P000000TTTTT000000T0TTTT0000T0TTTTTTTTTTTTTT000000T0TTTT0000T0TTTTTTTTTTTTTT000000T0TTTT0000T00000
T000000T0TTTTT000000T0TTTT0000T0TTTTTTTTTTTTTT000000T0TTTT0000T0TTTTTTTTTTTTTT000000T0TTTT0000T00000
T0000000000000000000T0TTTT0000T0TTTTTTTTTTTTTT000000T0TTTT0000T0TTTTTTTTTTTTTT000000T0TTTT0000T00000
T000E0000TTTTT000000T000000000T0TTTTTTTTTTTTTT0000000000000000T0TTTTTTTTTTTTTT000000T0TTTT0000T00000
T00000000TTTTT000000T0TTTT0000T0TT0000000000000000000000000000T000000000000000000000T000000000T00000
TT0000000TTTTT000000T0TTTT0000T000000000000000000000T0TTTT0000T0TTTTTTTTTTTTTT000000T0TTTT0000T00000
T0000T000TTTTT000000T0TTTT0000T0TTTTTTTTTTTTTT000000T0TTTT0000T0TTTTTTTTTTTTTT000000T0TTTT0000T00000
TTTTTTTTTTTTTT000000T0TTTT0000T0TTTTTTTTTTTTTT000000T0TTTT0000T0TTTTTTTTTTTTTT000000T0TTTT0000T00000
TTTTTTTTTTTTTT000000T0TTTT0000T0TTTTTTTTTTTTTT000000T0TTTT0000T0TTTTTTTTTTTTTT000000T0TTTT0000T00000
T00T00000TTTTT000000T0TTTT0000T0TTTTTTTTTTTTTT000000T0TTTT0000T0TTTTTTTTTTTTTT000000T0TTTT0000T00000
T00000000TTTTT000000T0TTTT0000T0TTTTTTTTTTTTTT000000T0TTTT0000T0TTTTTTTTTTTTTT000000T0TTTT0000T00000
T000000T0TTTTT000000T0TTTT0000T0TTTTTTTTTTTTTT0000000000000000T0TTTTTTTTTTTTTT000000T0TTTT0000T00000
T0000000000000000000T0TTTT0000T0TTTTTTTTTTTTTT0000000000000000T0TTTTTTTTTTTTTT000000T0TTTT0000T00000
T000E0000TTTTT000000T000000000T0TTTTTTTTTTTTTT0000000000000000T0TTTTTTTTTTTTTT000000T0TTTT0000T00000
T00000000TTTTT000000T0TTTT0000T0TT0000000000000000000000000000T000000000000000000000T000000000T00000
TT0000000TTTTT000000T0TTTT0000T0000000000000000000000000000000T0TTTTTTTTTTTTTT000000T0TTTT0000T00000
T0000T000TTTTT000000T0TTTT0000T0TTTTTTTTTTTTTT000000T0TTTT0000T0TTTTTTTTTTTTTT000000T0TTTT0000T00000
TTTTTTTTTTTTTT000000T0TTTT0000T0TTTTTTTTTTTTTT000000T0TTTT0000T0TTTTTTTTTTTTTT000000T0TTTT0000T00000
TTTTTTTTTTTTTT000000T0TTTT0000T0TTTTTTTTTTTTTT000000T0TTTT0000T0TTTTTTTTTTTTTT000000T0TTTT0000T00000
T00T00000TTTTT000000T0TTTT0000T0TTTTTTTTTTTTTT000000T0TTTT0000T0TTTTTTTTTTTTTT000000T0TTTT0000T00000
T00000000TTTTT000000T0TTTT0000T0TTTTTTTTTTTTTT000000T0TTTT0000T0TTTTTTTTTTTTTT000000T0TTTT0000T00000
T000000T0TTTTT000000T0TTTT0000T0TTTTTTTTTTTTTT000000T0TTTT0000T0TTTTTTTTTTTTTT000000T0TTTT0000T00000
T0000000000000000000T0TTTT0000T0TTTTTTTTTTTTTT00000000000000000000000000000000000000T0TTTT0000T00000
T000E0000TTTTT000000T000000000T0TTTTTTTTTTTTTT000000T0TTTT0000T000000000000000000000T0TTTT0000T00000
T00000000TTTTT000000T0TTTT0000T0TT000000000000000000T0TTTT0000T000000000000000000000T000000000T00000
TT0000000TTTTT000000T0TTTT0000T000000000000000000000T0TTTT0000T0TTTTTTTTTTTTTT000000T0TTTT0000T00000
T0000T000TTTTT000000T0TTTT0000T0TTTTTTTTTTTTTT000000T0TTTT0000T0TTTTTTTTTTTTTT000000T0TTTT0000T00000
TTTTTTTTTTTTTT000000T0TTTT0000T0TTTTTTTTTTTTTT000000T0TTTT0000T0TTTTTTTTTTTTTT000000T0TTTT0000T00000
TTTTTTTTTTTTTT000000T0TTTT0000T0TTTTTTTTTTTTTT000000T0TTTT0000T0TTTTTTTTTTTTTT000000T0TTTT0000T00000
T00T00000TTTTT000000T0TTTT0000T0TTTTTTTTTTTTTT000000T0TTTT0000T0TTTTTTTTTTTTTT000000T0TTTT0000T00000
T00000000TTTTT000000T0TTTT0000T0TTTTTTTTTTTTTT000000T0TTTT0000T0TTTTTTTTTTTTTT000000T0TTTT0000T00000
T000000T0TTTTT000000T0TTTT0000T0TTTTTTTTTTTTTT0000000000000000T0TTTTTTTTTTTTTT000000T0TTTT0000T00000
T0000000000000000000T0TTTT0000T0TTTTTTTTTTTTTT0000000000000000T0TTTTTTTTTTTTTT000000T0TTTT0000T00000
T000E0000TTTTT000000T000000000T0TTTTTTTTTTTTTT0000000000000000T0TTTTTTTTTTTTTT000000T0TTTT0000T00000
T00000000TTTTT000000T0TTTT0000T0TT000000000000000000T000000000T000000000000000000000T000000000T00000
TT0000000TTTTT000000T0TTTT0000T000000000000000000000T0TTTT0000T0TTTTTTTTTTTTTT000000T0TTTT0000T00000
T0000T000TTTTT000000T0TTTT0000T0TTTTTTTTTTTTTT000000T0TTTT0000T0TTTTTTTTTTTTTT000000T0TTTT0000T00000
TTTTTTTTTTTTTT000000T0TTTT0000T0TTTTTTTTTTTTTT000000T0TTTT0000T0TTTTTTTTTTTTTT000000T0TTTT0000T00000