0000000000
000T000000
00P0000000
0000000T00
0000000000
0000E00000
0000000000
0T00000000
00000T0000
00E0000E00
