TTTTTTTTTT
T00T00000T
T0P000000T
T000000T0T
T00000000T
T000E0000T
T00000000T
TT0000000T
T0000T000T
TTTTTTTTTT