000000000000000000000000000000000000000
0W00000000000000000000000000000000000W0
000000000000000000000000000000000000000
00000000HHHHHHHC000000000000000000T0T00
00000000V00000C00000000000000000000T000
00000000V0000000000000T0000000000000000
00000000V0KHH000000000TT000000000000000
00000000V00O0V0000000000000000000000000
00000000KHHHHVC000000T00000000000000V00
0000000T0000B00000000000000000000000V00
00000000TT00000000000000000000000000V00
000000T00T00000000000000000000000000000
0000000T0000B0000000P000000000000000V00
00000000TT00000000000000000000000000V00
000000T00T00000000000000000000000000000
0000000T0000B00000000000000000000000V00
00000000TT00000000000000000000000000V00
000000T00T00000000000000000000000000000
0000000T0000B00000000000000000000000V00
0W00000000000000000000000000000000000W0
000000000000000000000000000000000000000